{
  "walls": [
    "11111111111111111111111111111111111111111111",
    "10000000000000000000000000000000000000000001",
    "10000000000000000000000000000000000000000001",
    "10000001111111111100000000000000000000000001",
    "10000000000000000100000000000000000000000001",
    "10000000000000000100000000000000000000000001",
    "10000001111111111100000111111111111000000001",
    "10000000000000000000000100000000001000000001",
    "10000000000000000000000000001111001000000001",
    "10000000000000000000000100000000001000000001",
    "10000000000000000000000111111111111000000001",
    "10000000000000000000000000000000000000000001",
    "10000000000000000000000000000000000000000001",
    "11111111111111111111111111111111111111111111"
  ],
  "floor": [
    "11111111111111111111111111111111111111111111",
    "10000000000000000000000000000000000000000001",
    "10000000000000000000000000000000000000000001",
    "10000001111111111100000000000000000000000001",
    "10000000000000000100000000000000000000000001",
    "10000000000000000100000000000000000000000001",
    "10000001111111111100000111111111111000000001",
    "10000000000000000000000100000000001000000001",
    "10000000000000000000000000001111001000000001",
    "10000000000000000000000100000000001000000001",
    "10000000000000000000000111111111111000000001",
    "10000000000000000000000000000000000000000001",
    "10000000000000000000000000000000000000000001",
    "11111111111111111111111111111111111111111111"
  ],
  "ceiling": [
    "11111111111111111111111111111111111111111111",
    "10000000000000000000000000000000000000000001",
    "10000000000000000000000000000000000000000001",
    "10000001111111111100000000000000000000000001",
    "10000000000000000100000000000000000000000001",
    "10000000000000000100000000000000000000000001",
    "10000001111111111100000111111111111000000001",
    "10000000000000000000000100000000001000000001",
    "10000000000000000000000000001111001000000001",
    "10000000000000000000000100000000001000000001",
    "10000000000000000000000111111111111000000001",
    "10000000000000000000000000000000000000000001",
    "10000000000000000000000000000000000000000001",
    "11111111111111111111111111111111111111111111"
  ]
}
