{
  "textures": {
    "walls": {
      "1": "gold.jpg",
      "2": "checkerboard.jpg"
    },
    "floor": {
      "1": "checkerboard.jpg"
    },
    "ceiling": {
      "1": "checkerboard.jpg"
    },
    "door": {
      "1": "door.jpg"
    },
    "items": {
      "chair": "chair.jpg"
    }
  },
  "level": [
    "11111111111111111111111111111111111111111111",
    "10000000000000000000000000000000000000000001",
    "10000000000000000000000000000000000000000001",
    "10000002222222222200000000000000000000000001",
    "10000000000000000200000000000000000000000001",
    "10000000000000000200000000000000000000000001",
    "10000002222222222200000222222222222000000001",
    "10000000000000000000000200000000002000000001",
    "10000000000000000000000000002222002000000001",
    "10000000000000000000000200000000002000000001",
    "10000000000000000000000222222222222000000001",
    "10000000000000000000000000000000000000000001",
    "10000000000000000000000000000000000000000001",
    "11111111111111111111111111111111111111111111"
  ]
}
