{
  "textures": {
    "walls": {
      "1": "gold.jpg",
      "2": "checkerboard.jpg",
      "3": "stone.jpg"
    },
    "floor": {
      "1": "checkerboard.jpg"
    },
    "ceiling": {
      "1": "checkerboard.jpg"
    },
    "door": {
      "1": "door.jpg"
    },
    "items": {
      "chair": "chair.jpg"
    },
    "entities": {
      "skeleton": "skeleton.png"
    }
  },
  "walls": [
    "11111111111111111111111111111111111111111111",
    "10000000000000000000000000000000000000000001",
    "10000000000000000000000022222222200000000001",
    "10000003333333333300000000000000000000000001",
    "10000000000000000300000000000000000000000001",
    "10000000000000000300000000000000000000000001",
    "10000003333333333300000333333333333000000001",
    "10000000000000000000000100000000003000000001",
    "10000000000000000000000000003333003000000001",
    "10000000000000000000000100000000003000000001",
    "10000000000000000000000333333333333000000001",
    "10000000000000000000000000000000000000000001",
    "10000000000000000000000000000000000000000001",
    "11111111111111111111111111111111111111111111"
  ],
  "floor": [
    "00000000000000000000000000000000000000000000",
    "01111111111111111111111111111111111111111110",
    "01111111111111111111111111111111111111111110",
    "01111110000000000011111111111111111111111110",
    "01111111111111111011111111111111111111111110",
    "01111111111111111011111111111111111111111110",
    "01111110000000000011111000000000000111111110",
    "01111111111111111111111111111111110111111110",
    "01111111111111111111111111110000110111111110",
    "01111111111111111111111111111111110111111110",
    "01111111111111111111111000000000000111111110",
    "01111111111111111111111111111111111111111110",
    "01111111111111111111111111111111111111111110",
    "00000000000000000000000000000000000000000000"
  ],
  "ceiling": [
    "00000000000000000000000000000000000000000000",
    "01111111111111111111111111111111111111111110",
    "01111111111111111111111111111111111111111110",
    "01111110000000000011111111111111111111111110",
    "01111111111111111011111111111111111111111110",
    "01111111111111111011111111111111111111111110",
    "01111110000000000011111000000000000111111110",
    "01111111111111111111111111111111110111111110",
    "01111111111111111111111111110000110111111110",
    "01111111111111111111111111111111110111111110",
    "01111111111111111111111000000000000111111110",
    "01111111111111111111111111111111111111111110",
    "01111111111111111111111111111111111111111110",
    "00000000000000000000000000000000000000000000"
  ]
}
